[0, 1, 1, 2, 0, 2, 2, 2, 1, 0, 1, 1, 2, 1, 2, 2, 2, 2, 2, 0, 0, 0, 0, 0, 1, 0, 1, 2, 2, 0, 0, 0, 0, 0, 2, 0, 1, 0, 1, 2, 2, 2, 8, 0, 9, 0, 0, 4, 0, 2, 0, 12, 1, 7, 0, 0, 4, 6, 5, 0, 2, 2, 1, 7, 2, 7, 0, 0, 0, 0, 3, 0, 11, 0, 0, 0, 9, 0, 2, 7, 2, 9, 2, 8, 0, 13, 0, 0, 2, 9, 0, 0, 2, 1, 0, 4, 2, 2, 3, 2, 0]
[0, 1, 1, 2, 0, 2, 2, 2, 1, 0, 1, 1, 2, 1, 2, 2, 2, 2, 2, 0, 0, 0, 0, 0, 1, 0, 1, 2, 2, 0, 0, 0, 0, 0, 2, 0, 2, 2, 1, 1, 1, 2, 2, 1, 1, 1, 0, 1, 0, 0, 2, 2, 1, 0, 2, 0, 2, 2, 2, 0, 2, 2, 1, 1, 1, 1, 0, 1, 0, 0, 0, 0, 0, 1, 2, 0, 0, 0, 2, 0, 2, 2, 2, 1, 0, 1, 2, 1, 2, 2, 0, 1, 2, 1, 4, 0, 0, 8, 1, 1, 1]
[0, 1, 1, 2, 13, 0, 3, 0, 0, 1, 2, 6, 1, 0, 0, 0, 1, 2, 1, 0, 0, 2, 2, 0, 2, 0, 0, 2, 2, 0, 7, 0, 0, 3, 3, 0, 2, 2, 1, 1, 1, 2, 2, 1, 1, 0, 1, 3, 0, 0, 9, 2, 1, 2, 1, 0, 1, 0, 2, 2, 1, 0, 6, 0, 2, 0, 0, 2, 2, 0, 1, 0, 0, 9, 2, 0, 0, 0, 2, 0, 2, 2, 9, 1, 0, 1, 6, 1, 2, 2, 0, 1, 2, 0, 1, 0, 5, 1, 0, 1, 2]
[0, 1, 1, 2, 0, 2, 2, 2, 1, 0, 1, 1, 2, 1, 2, 2, 2, 2, 2, 0, 0, 0, 0, 0, 1, 0, 1, 2, 2, 0, 0, 0, 0, 3, 3, 0, 2, 2, 1, 1, 1, 2, 2, 1, 1, 0, 1, 3, 0, 0, 9, 2, 1, 2, 1, 0, 1, 0, 2, 2, 1, 0, 6, 0, 2, 0, 0, 2, 2, 0, 1, 0, 0, 9, 2, 0, 0, 0, 2, 0, 2, 2, 9, 1, 0, 1, 6, 1, 2, 2, 0, 1, 2, 0, 1, 0, 5, 1, 0, 1, 2]
[0, 1, 1, 2, 13, 0, 3, 0, 0, 1, 2, 6, 1, 0, 0, 0, 1, 2, 1, 0, 0, 2, 2, 0, 2, 0, 0, 2, 2, 0, 7, 0, 0, 3, 3, 0, 2, 2, 1, 1, 1, 2, 2, 1, 1, 0, 1, 1, 0, 0, 2, 2, 1, 0, 2, 0, 2, 2, 2, 0, 0, 0, 1, 0, 2, 0, 1, 2, 2, 1, 1, 0, 0, 1, 2, 0, 0, 0, 2, 0, 2, 2, 2, 1, 0, 1, 2, 1, 2, 2, 0, 1, 2, 1, 4, 0, 0, 8, 1, 1, 1]
[0, 1, 1, 2, 0, 2, 2, 2, 1, 0, 1, 1, 2, 1, 2, 2, 2, 2, 2, 0, 0, 0, 0, 0, 1, 0, 1, 2, 2, 0, 0, 0, 0, 0, 2, 0, 2, 2, 1, 1, 1, 2, 2, 1, 1, 0, 1, 3, 0, 0, 9, 2, 1, 2, 1, 0, 1, 0, 2, 2, 1, 0, 6, 0, 2, 0, 0, 2, 2, 0, 1, 0, 0, 9, 2, 0, 0, 0, 2, 0, 2, 2, 9, 1, 0, 1, 6, 1, 2, 2, 0, 1, 2, 0, 1, 0, 5, 1, 0, 1, 2]
[0, 1, 1, 2, 13, 0, 3, 0, 0, 1, 2, 6, 1, 0, 0, 0, 1, 2, 1, 0, 0, 2, 2, 0, 2, 0, 0, 2, 2, 0, 7, 0, 0, 3, 3, 0, 2, 2, 1, 1, 1, 2, 2, 1, 1, 0, 1, 3, 0, 0, 9, 2, 1, 2, 1, 0, 1, 0, 2, 2, 1, 0, 6, 0, 2, 0, 0, 2, 2, 0, 1, 0, 0, 9, 2, 0, 0, 0, 2, 0, 2, 2, 9, 1, 0, 1, 6, 1, 2, 2, 0, 1, 2, 0, 1, 0, 5, 1, 0, 1, 2]
[0, 1, 1, 2, 13, 0, 3, 0, 0, 1, 2, 6, 1, 0, 0, 0, 1, 2, 1, 0, 0, 2, 2, 0, 2, 0, 0, 2, 2, 0, 7, 0, 0, 3, 3, 0, 2, 2, 1, 1, 1, 2, 2, 1, 1, 1, 1, 1, 0, 0, 2, 2, 1, 0, 2, 0, 2, 2, 2, 0, 0, 0, 1, 0, 2, 0, 1, 2, 2, 1, 1, 0, 1, 0, 0, 1, 2, 0, 1, 1, 0, 0, 2, 0, 0, 2, 1, 2, 2, 0, 0, 1, 2, 1, 4, 0, 0, 8, 1, 1, 1]
[0, 1, 1, 2, 0, 2, 2, 2, 1, 0, 1, 1, 2, 1, 2, 2, 2, 2, 2, 0, 0, 0, 0, 0, 1, 0, 1, 2, 2, 0, 0, 0, 0, 0, 2, 0, 2, 2, 1, 1, 1, 2, 2, 1, 1, 1, 0, 3, 0, 2, 0, 5, 5, 0, 0, 0, 4, 6, 5, 3, 2, 2, 1, 7, 2, 1, 0, 0, 0, 0, 0, 0, 0, 1, 2, 0, 0, 0, 2, 0, 2, 2, 2, 1, 0, 1, 2, 1, 2, 2, 1, 0, 1, 1, 0, 1, 2, 2, 1, 2, 0]
[0, 1, 1, 2, 0, 2, 2, 2, 1, 0, 1, 1, 2, 1, 2, 2, 2, 2, 2, 0, 0, 0, 0, 0, 1, 0, 1, 2, 2, 0, 0, 0, 0, 0, 2, 0, 2, 2, 1, 1, 1, 2, 2, 1, 1, 1, 0, 3, 0, 2, 0, 5, 5, 0, 0, 0, 4, 6, 5, 3, 2, 2, 1, 7, 2, 1, 0, 0, 0, 0, 0, 0, 6, 1, 0, 0, 6, 0, 2, 7, 2, 9, 2, 1, 0, 13, 0, 0, 2, 9, 0, 0, 9, 2, 0, 0, 0, 0, 2, 0, 2]
[0, 6, 0, 3, 0, 2, 8, 5, 0, 0, 4, 3, 2, 1, 2, 4, 0, 8, 2, 0, 5, 0, 0, 0, 2, 2, 7, 2, 0, 6, 0, 0, 0, 0, 2, 0, 2, 2, 1, 1, 2, 2, 2, 1, 1, 1, 4, 5, 0, 0, 2, 9, 1, 0, 2, 0, 2, 9, 2, 0, 0, 0, 1, 0, 2, 0, 1, 2, 2, 3, 1, 0, 1, 0, 7, 1, 2, 0, 1, 1, 0, 0, 2, 0, 0, 2, 2, 0, 0, 8, 0, 0, 0, 1, 0, 2, 0, 0, 1, 0, 0]
[0, 8, 0, 2, 0, 2, 0, 0, 1, 0, 4, 7, 2, 1, 2, 2, 2, 2, 2, 0, 0, 0, 0, 0, 6, 0, 0, 7, 2, 0, 0, 2, 4, 0, 2, 0, 0, 2, 1, 2, 4, 2, 2, 0, 1, 1, 1, 0, 0, 2, 2, 2, 1, 0, 0, 0, 0, 6, 5, 3, 2, 9, 1, 7, 5, 7, 0, 0, 0, 0, 3, 0, 11, 0, 5, 6, 9, 0, 0, 7, 2, 9, 2, 8, 0, 18, 0, 0, 0, 9, 0, 0, 3, 0, 0, 4, 2, 0, 3, 2, 5]
[0, 1, 1, 2, 0, 2, 2, 2, 1, 0, 1, 1, 2, 1, 2, 2, 2, 2, 2, 0, 0, 0, 0, 0, 1, 0, 1, 2, 2, 0, 0, 0, 0, 0, 2, 0, 2, 2, 1, 1, 1, 2, 2, 1, 1, 1, 1, 1, 0, 0, 2, 2, 1, 2, 1, 0, 1, 0, 2, 2, 1, 0, 6, 0, 2, 0, 0, 2, 2, 0, 1, 0, 0, 9, 2, 0, 0, 0, 2, 0, 2, 2, 9, 1, 0, 1, 6, 1, 2, 2, 0, 1, 2, 0, 1, 0, 5, 1, 0, 1, 2]
[0, 6, 1, 2, 0, 2, 8, 0, 0, 0, 1, 3, 2, 1, 2, 0, 0, 5, 2, 0, 0, 0, 0, 0, 2, 2, 7, 2, 0, 6, 0, 0, 6, 1, 1, 0, 2, 0, 0, 1, 4, 2, 0, 0, 0, 2, 5, 0, 0, 2, 0, 0, 0, 0, 15, 2, 0, 1, 0, 0, 0, 0, 0, 7, 1, 2, 2, 0, 1, 0, 0, 2, 2, 0, 4, 2, 2, 0, 0, 7, 0, 1, 2, 1, 0, 5, 6, 0, 5, 0, 4, 1, 4, 1, 1, 0, 3, 2, 1, 0, 1]
[1, 1, 6, 2, 6, 6, 0, 0, 0, 4, 0, 0, 1, 0, 0, 0, 1, 2, 0, 0, 0, 2, 1, 0, 9, 7, 0, 0, 2, 14, 2, 0, 4, 0, 0, 0, 1, 0, 1, 2, 2, 2, 8, 0, 9, 0, 0, 4, 0, 2, 0, 12, 1, 7, 0, 0, 4, 6, 5, 0, 2, 2, 1, 7, 2, 7, 0, 0, 0, 0, 3, 0, 11, 0, 0, 0, 9, 0, 2, 7, 2, 9, 2, 8, 0, 13, 0, 0, 2, 9, 0, 0, 2, 1, 0, 4, 2, 2, 3, 2, 0]
[0, 1, 1, 2, 0, 2, 2, 2, 1, 0, 1, 1, 2, 1, 2, 2, 2, 2, 2, 0, 0, 0, 0, 0, 1, 0, 1, 2, 2, 0, 0, 0, 0, 0, 2, 0, 2, 2, 1, 1, 1, 2, 2, 1, 1, 1, 1, 1, 0, 0, 2, 2, 1, 0, 2, 0, 2, 2, 2, 0, 0, 0, 1, 0, 2, 0, 1, 2, 0, 0, 0, 0, 0, 1, 2, 0, 0, 0, 2, 0, 2, 2, 2, 1, 0, 1, 2, 1, 2, 2, 0, 1, 2, 1, 4, 0, 0, 8, 1, 1, 1]
[0, 1, 1, 6, 2, 1, 0, 0, 0, 0, 2, 0, 6, 1, 0, 2, 6, 2, 1, 4, 0, 2, 7, 0, 0, 7, 0, 2, 2, 0, 2, 0, 1, 1, 3, 0, 2, 7, 1, 0, 1, 3, 2, 1, 1, 0, 1, 3, 0, 2, 9, 0, 1, 2, 2, 0, 1, 0, 2, 1, 0, 0, 6, 0, 2, 0, 0, 4, 2, 0, 1, 0, 0, 9, 2, 0, 0, 7, 2, 0, 7, 0, 4, 0, 0, 1, 9, 1, 8, 6, 1, 2, 8, 0, 1, 6, 5, 0, 2, 2, 2]
[0, 1, 1, 6, 2, 1, 0, 0, 0, 0, 2, 0, 6, 1, 0, 2, 6, 2, 1, 4, 0, 2, 7, 0, 0, 7, 0, 2, 2, 0, 2, 0, 1, 1, 1, 0, 2, 0, 0, 2, 2, 2, 0, 0, 2, 4, 0, 0, 0, 2, 0, 6, 6, 1, 2, 0, 2, 2, 0, 5, 2, 2, 0, 1, 1, 7, 0, 1, 0, 0, 0, 0, 0, 1, 2, 1, 6, 0, 7, 0, 2, 2, 5, 4, 0, 0, 2, 1, 0, 2, 0, 0, 3, 4, 4, 3, 1, 2, 0, 2, 0]
[0, 1, 1, 2, 0, 2, 0, 2, 1, 1, 1, 1, 2, 1, 2, 2, 0, 2, 2, 0, 3, 0, 0, 0, 1, 0, 5, 2, 2, 0, 0, 0, 6, 0, 2, 5, 0, 2, 1, 3, 5, 2, 2, 8, 4, 0, 1, 2, 0, 0, 9, 2, 1, 2, 4, 0, 0, 0, 5, 0, 2, 2, 1, 1, 2, 7, 0, 0, 0, 0, 0, 0, 11, 0, 0, 0, 2, 0, 9, 13, 2, 4, 2, 7, 0, 13, 0, 0, 9, 9, 0, 0, 5, 1, 0, 4, 2, 2, 6, 0, 0]
[0, 1, 1, 2, 0, 2, 2, 2, 1, 0, 1, 1, 2, 1, 2, 2, 2, 2, 2, 0, 0, 0, 0, 0, 1, 0, 1, 2, 2, 0, 0, 0, 0, 0, 2, 0, 2, 2, 1, 1, 1, 2, 2, 1, 1, 1, 0, 3, 0, 2, 0, 5, 5, 0, 0, 0, 4, 6, 5, 3, 2, 2, 1, 7, 2, 1, 0, 0, 0, 0, 0, 2, 2, 0, 4, 2, 2, 0, 0, 7, 2, 2, 2, 1, 0, 1, 2, 1, 2, 2, 0, 1, 2, 1, 4, 0, 0, 8, 1, 1, 1]
[0, 1, 1, 2, 0, 2, 2, 2, 1, 0, 1, 1, 2, 1, 2, 2, 2, 2, 2, 0, 0, 0, 0, 0, 1, 0, 1, 2, 2, 0, 0, 0, 0, 0, 2, 0, 2, 2, 1, 1, 1, 2, 2, 1, 1, 1, 1, 1, 0, 0, 2, 2, 1, 0, 2, 0, 2, 2, 2, 0, 0, 0, 1, 0, 2, 0, 1, 2, 2, 1, 1, 0, 0, 1, 2, 0, 0, 0, 2, 0, 2, 2, 2, 1, 0, 1, 2, 1, 2, 2, 0, 1, 2, 1, 4, 0, 0, 8, 1, 1, 1]
[0, 1, 1, 6, 2, 1, 0, 0, 0, 0, 2, 0, 6, 1, 0, 2, 6, 2, 1, 4, 0, 3, 1, 0, 2, 0, 0, 2, 2, 0, 7, 0, 1, 1, 1, 0, 2, 0, 0, 2, 2, 2, 0, 0, 2, 0, 0, 0, 0, 2, 0, 0, 1, 1, 2, 0, 2, 2, 2, 0, 2, 2, 1, 1, 1, 1, 0, 1, 0, 0, 0, 0, 0, 1, 2, 0, 0, 0, 2, 0, 2, 2, 2, 1, 0, 1, 2, 1, 2, 2, 2, 1, 2, 2, 1, 0, 0, 1, 0, 1, 2]
[0, 6, 0, 3, 0, 2, 8, 5, 0, 0, 4, 3, 2, 1, 2, 4, 0, 8, 2, 0, 5, 0, 0, 0, 2, 2, 7, 2, 0, 6, 0, 0, 0, 0, 2, 0, 2, 2, 1, 1, 2, 2, 2, 1, 1, 1, 4, 1, 0, 0, 2, 2, 1, 0, 2, 0, 2, 2, 2, 0, 0, 0, 1, 0, 2, 0, 1, 2, 2, 1, 1, 0, 1, 0, 0, 1, 2, 0, 1, 1, 0, 0, 2, 0, 0, 2, 2, 0, 2, 2, 0, 1, 0, 1, 1, 2, 0, 1, 2, 1, 0]
[7, 6, 1, 2, 0, 0, 2, 2, 6, 0, 0, 1, 1, 1, 0, 2, 3, 0, 1, 0, 0, 0, 0, 1, 1, 0, 1, 2, 2, 5, 7, 0, 0, 0, 0, 0, 2, 2, 6, 1, 1, 2, 2, 1, 1, 1, 1, 4, 0, 0, 3, 8, 0, 2, 1, 7, 1, 0, 2, 2, 1, 0, 6, 0, 5, 0, 1, 7, 9, 3, 1, 0, 3, 0, 7, 1, 2, 7, 7, 0, 5, 0, 2, 0, 0, 2, 2, 4, 0, 8, 0, 0, 7, 0, 0, 2, 0, 0, 2, 0, 0]
[0, 1, 1, 2, 0, 2, 2, 2, 1, 0, 1, 1, 2, 1, 2, 2, 2, 2, 2, 0, 0, 0, 0, 0, 1, 0, 1, 2, 2, 0, 0, 0, 0, 0, 2, 0, 2, 2, 1, 1, 1, 2, 2, 1, 1, 1, 1, 1, 0, 0, 9, 2, 1, 2, 1, 0, 1, 0, 2, 2, 1, 0, 6, 0, 2, 0, 0, 2, 2, 0, 1, 0, 0, 9, 2, 0, 0, 0, 2, 0, 2, 2, 9, 1, 0, 1, 6, 1, 2, 2, 0, 1, 2, 0, 1, 0, 5, 1, 0, 1, 2]
[0, 6, 1, 2, 0, 2, 8, 0, 0, 0, 1, 0, 6, 1, 0, 2, 6, 2, 1, 4, 0, 2, 7, 0, 0, 7, 0, 2, 2, 0, 2, 0, 1, 1, 1, 0, 2, 0, 0, 2, 2, 2, 0, 0, 2, 4, 0, 0, 0, 2, 0, 6, 6, 1, 2, 0, 2, 2, 0, 5, 2, 2, 0, 1, 1, 7, 0, 1, 0, 0, 0, 0, 0, 1, 2, 1, 6, 0, 7, 0, 2, 2, 5, 4, 0, 0, 2, 1, 0, 2, 0, 0, 3, 4, 4, 3, 1, 2, 0, 2, 0]
[0, 1, 1, 2, 0, 2, 2, 2, 1, 0, 1, 1, 2, 1, 2, 2, 2, 2, 2, 0, 0, 0, 0, 0, 1, 0, 1, 2, 2, 0, 0, 0, 0, 0, 2, 0, 2, 2, 1, 1, 1, 2, 2, 1, 1, 1, 1, 1, 0, 0, 2, 2, 1, 0, 2, 0, 2, 2, 2, 0, 0, 0, 1, 0, 2, 0, 1, 2, 0, 0, 0, 0, 0, 1, 2, 0, 0, 0, 2, 0, 2, 2, 2, 1, 0, 1, 2, 1, 2, 2, 0, 1, 2, 1, 4, 0, 0, 8, 1, 1, 1]
[5, 3, 0, 2, 0, 2, 7, 2, 1, 5, 4, 7, 2, 3, 2, 5, 0, 2, 0, 2, 0, 3, 0, 0, 7, 0, 0, 7, 0, 7, 0, 2, 4, 0, 2, 0, 3, 2, 7, 2, 4, 1, 0, 0, 1, 4, 0, 0, 0, 2, 9, 0, 0, 2, 2, 0, 1, 0, 2, 1, 0, 0, 6, 0, 2, 0, 0, 4, 3, 0, 1, 0, 0, 9, 8, 0, 0, 7, 2, 0, 12, 0, 4, 0, 0, 0, 9, 1, 8, 7, 1, 2, 8, 0, 6, 6, 5, 0, 7, 2, 2]
[0, 1, 1, 2, 13, 0, 3, 0, 0, 1, 2, 6, 1, 0, 0, 0, 1, 2, 1, 0, 0, 2, 2, 0, 2, 0, 0, 2, 2, 0, 7, 0, 0, 3, 3, 0, 2, 2, 1, 1, 1, 2, 2, 1, 1, 0, 1, 1, 0, 0, 2, 2, 1, 0, 2, 0, 2, 2, 2, 0, 0, 0, 1, 0, 2, 0, 1, 2, 2, 1, 1, 0, 0, 1, 2, 0, 0, 0, 2, 0, 2, 2, 2, 1, 0, 1, 2, 1, 2, 2, 0, 0, 1, 1, 0, 1, 2, 2, 1, 2, 0]
[0, 6, 0, 3, 0, 2, 8, 5, 0, 0, 4, 3, 2, 1, 2, 4, 0, 8, 2, 0, 5, 0, 0, 0, 2, 2, 7, 2, 0, 6, 0, 0, 0, 0, 2, 0, 2, 2, 1, 1, 2, 2, 2, 1, 1, 1, 4, 1, 0, 0, 2, 2, 1, 0, 2, 0, 2, 2, 2, 0, 0, 0, 1, 0, 2, 0, 1, 2, 2, 0, 3, 0, 11, 0, 5, 6, 9, 0, 0, 7, 2, 9, 2, 8, 0, 18, 0, 0, 0, 9, 0, 0, 3, 0, 0, 4, 2, 0, 3, 2, 5]
[0, 1, 1, 6, 2, 1, 0, 0, 0, 0, 2, 0, 6, 1, 0, 2, 6, 2, 1, 4, 0, 3, 1, 0, 2, 0, 0, 2, 2, 0, 7, 0, 1, 1, 1, 0, 2, 0, 0, 2, 2, 2, 0, 0, 2, 0, 0, 0, 0, 2, 0, 0, 1, 1, 2, 0, 2, 2, 2, 0, 2, 2, 1, 1, 1, 1, 0, 1, 0, 0, 0, 0, 0, 1, 2, 0, 0, 0, 2, 0, 2, 2, 2, 1, 0, 1, 2, 1, 2, 2, 2, 1, 2, 2, 1, 0, 0, 1, 0, 1, 2]
[0, 1, 0, 9, 0, 2, 2, 9, 0, 0, 5, 1, 3, 1, 2, 2, 2, 0, 2, 0, 0, 0, 0, 0, 2, 2, 7, 2, 0, 6, 0, 1, 0, 0, 0, 0, 0, 4, 0, 3, 0, 0, 3, 0, 7, 1, 6, 1, 0, 0, 2, 0, 1, 0, 5, 0, 5, 2, 2, 7, 0, 0, 1, 3, 2, 0, 1, 2, 2, 7, 1, 0, 0, 0, 0, 1, 2, 0, 8, 1, 0, 0, 0, 0, 0, 9, 2, 7, 2, 2, 0, 4, 1, 1, 1, 2, 0, 1, 0, 0, 0]
[0, 6, 0, 3, 0, 0, 8, 5, 0, 7, 4, 0, 2, 1, 2, 7, 0, 13, 0, 0, 5, 0, 0, 0, 2, 2, 7, 5, 5, 6, 0, 0, 0, 5, 2, 0, 2, 2, 1, 1, 2, 2, 1, 1, 1, 7, 4, 5, 0, 0, 2, 2, 0, 7, 2, 6, 2, 6, 2, 0, 0, 0, 1, 0, 1, 7, 0, 0, 0, 0, 3, 0, 11, 0, 5, 13, 9, 0, 0, 7, 0, 9, 2, 8, 0, 24, 0, 0, 0, 16, 0, 6, 3, 7, 3, 4, 2, 0, 3, 2, 5]
[0, 1, 1, 2, 0, 2, 2, 2, 1, 0, 1, 1, 2, 1, 2, 2, 2, 2, 2, 0, 0, 0, 0, 0, 1, 0, 1, 2, 2, 0, 0, 0, 0, 0, 2, 0, 2, 2, 1, 1, 1, 2, 2, 1, 1, 1, 1, 0, 0, 2, 0, 0, 1, 1, 2, 0, 2, 2, 2, 0, 2, 2, 1, 1, 1, 1, 0, 1, 0, 0, 0, 0, 0, 1, 2, 0, 0, 0, 2, 0, 2, 2, 2, 1, 0, 1, 2, 1, 2, 2, 2, 1, 2, 2, 1, 0, 0, 1, 0, 1, 2]
[0, 6, 0, 3, 0, 2, 8, 5, 0, 0, 4, 3, 2, 1, 2, 4, 0, 8, 2, 0, 5, 0, 0, 0, 2, 2, 7, 2, 0, 6, 0, 0, 0, 0, 2, 0, 2, 2, 1, 1, 2, 2, 2, 1, 1, 1, 4, 1, 0, 0, 2, 2, 1, 0, 2, 0, 2, 2, 2, 0, 0, 0, 1, 0, 2, 0, 1, 2, 2, 1, 1, 0, 1, 0, 0, 1, 2, 0, 1, 1, 0, 0, 2, 0, 0, 2, 2, 1, 2, 2, 0, 1, 2, 0, 1, 0, 5, 1, 0, 1, 2]
[0, 8, 0, 2, 0, 2, 0, 0, 1, 0, 4, 7, 2, 1, 2, 2, 2, 2, 2, 0, 0, 0, 0, 0, 6, 0, 0, 7, 2, 0, 0, 2, 4, 0, 2, 0, 0, 2, 1, 2, 4, 2, 2, 0, 1, 1, 1, 0, 0, 2, 2, 2, 1, 0, 0, 0, 0, 6, 5, 3, 2, 9, 1, 7, 5, 7, 0, 0, 0, 3, 1, 0, 3, 0, 7, 1, 2, 7, 7, 0, 5, 0, 2, 0, 0, 2, 2, 4, 0, 8, 0, 0, 7, 0, 0, 2, 0, 0, 2, 0, 0]
[0, 1, 1, 6, 2, 1, 0, 0, 0, 0, 2, 0, 6, 1, 0, 2, 6, 2, 1, 4, 0, 2, 7, 0, 0, 7, 0, 2, 2, 0, 2, 0, 1, 1, 3, 0, 2, 7, 1, 0, 1, 3, 2, 1, 1, 0, 1, 3, 0, 2, 9, 0, 1, 0, 2, 0, 2, 2, 2, 0, 0, 0, 1, 0, 2, 0, 1, 2, 2, 1, 1, 0, 1, 0, 0, 1, 2, 0, 1, 1, 0, 0, 2, 0, 0, 2, 1, 2, 2, 0, 0, 1, 2, 1, 4, 0, 0, 8, 1, 1, 1]
[0, 8, 0, 2, 0, 2, 0, 0, 1, 0, 4, 7, 2, 1, 2, 2, 2, 2, 2, 0, 0, 0, 0, 0, 6, 0, 0, 7, 2, 0, 0, 2, 4, 0, 2, 0, 0, 2, 1, 2, 4, 2, 2, 0, 1, 1, 1, 0, 0, 2, 2, 2, 1, 0, 0, 0, 0, 6, 5, 0, 2, 2, 1, 7, 2, 7, 0, 0, 0, 0, 3, 0, 11, 0, 0, 0, 9, 0, 2, 7, 2, 9, 2, 8, 0, 13, 0, 0, 2, 9, 0, 0, 2, 1, 0, 4, 2, 2, 3, 2, 0]
[0, 1, 1, 6, 2, 1, 0, 0, 0, 0, 2, 0, 6, 1, 0, 2, 6, 2, 1, 4, 0, 2, 7, 0, 0, 7, 0, 2, 2, 0, 2, 0, 1, 1, 3, 0, 2, 7, 1, 0, 1, 3, 2, 1, 1, 0, 1, 3, 0, 2, 9, 0, 1, 2, 2, 0, 1, 0, 2, 1, 0, 0, 6, 0, 2, 0, 0, 4, 2, 0, 1, 0, 0, 9, 2, 0, 0, 7, 2, 0, 7, 0, 4, 0, 0, 1, 9, 1, 8, 6, 1, 2, 8, 0, 1, 6, 5, 0, 2, 2, 2]
[0, 1, 1, 2, 0, 2, 2, 2, 1, 0, 1, 1, 2, 1, 2, 2, 2, 2, 2, 0, 0, 0, 0, 0, 1, 0, 1, 2, 2, 0, 0, 0, 0, 0, 2, 0, 2, 2, 1, 1, 1, 2, 2, 1, 1, 1, 0, 3, 0, 2, 0, 6, 6, 1, 2, 0, 2, 2, 0, 5, 2, 2, 0, 1, 1, 7, 0, 1, 0, 0, 0, 0, 0, 1, 2, 1, 6, 0, 7, 0, 2, 2, 5, 4, 0, 0, 2, 1, 0, 2, 0, 0, 3, 4, 4, 3, 1, 2, 0, 2, 0]
[0, 1, 1, 2, 0, 2, 2, 2, 1, 0, 1, 1, 2, 1, 2, 2, 2, 2, 2, 0, 0, 0, 0, 0, 1, 0, 1, 2, 2, 0, 0, 0, 0, 0, 2, 0, 2, 2, 1, 1, 1, 2, 2, 1, 1, 1, 1, 1, 0, 0, 2, 2, 1, 2, 1, 0, 1, 0, 2, 2, 1, 0, 6, 0, 2, 0, 0, 2, 2, 0, 1, 0, 0, 9, 2, 0, 0, 0, 2, 0, 2, 2, 9, 1, 0, 1, 6, 1, 2, 2, 0, 1, 2, 0, 1, 0, 5, 1, 0, 1, 2]
[0, 0, 4, 6, 2, 1, 1, 0, 0, 0, 2, 0, 6, 7, 0, 2, 6, 2, 8, 4, 4, 2, 7, 0, 0, 4, 0, 5, 7, 0, 5, 0, 1, 0, 4, 0, 2, 0, 0, 1, 0, 4, 5, 0, 2, 0, 0, 0, 0, 2, 0, 1, 6, 1, 1, 0, 2, 2, 0, 5, 5, 0, 0, 0, 2, 0, 1, 0, 2, 1, 7, 0, 6, 1, 2, 3, 0, 0, 4, 3, 9, 6, 2, 1, 0, 1, 3, 1, 5, 0, 0, 1, 0, 1, 4, 0, 0, 10, 1, 2, 1]
[0, 0, 1, 2, 2, 1, 5, 0, 0, 0, 0, 0, 6, 0, 0, 2, 6, 2, 0, 0, 0, 3, 5, 0, 2, 0, 0, 1, 1, 1, 7, 0, 1, 3, 1, 0, 2, 4, 0, 2, 2, 0, 0, 0, 2, 1, 0, 4, 0, 5, 0, 2, 0, 1, 2, 0, 2, 9, 4, 0, 2, 2, 1, 1, 1, 1, 2, 2, 7, 0, 0, 7, 1, 0, 7, 1, 2, 0, 1, 1, 0, 0, 0, 0, 5, 0, 2, 0, 0, 7, 0, 0, 0, 1, 0, 0, 0, 0, 1, 0, 0]
[0, 1, 1, 2, 0, 2, 2, 2, 1, 0, 1, 1, 2, 1, 2, 2, 2, 2, 2, 0, 0, 0, 0, 0, 1, 0, 1, 2, 2, 0, 0, 0, 0, 0, 2, 0, 2, 2, 1, 1, 1, 2, 2, 1, 1, 0, 1, 3, 0, 0, 0, 12, 1, 7, 0, 0, 4, 6, 5, 0, 2, 2, 1, 7, 2, 7, 0, 0, 0, 0, 3, 0, 11, 0, 0, 0, 9, 0, 2, 7, 2, 9, 2, 8, 0, 13, 0, 0, 2, 9, 0, 0, 2, 1, 0, 4, 2, 2, 3, 2, 0]
[0, 1, 1, 2, 0, 2, 2, 2, 1, 0, 1, 1, 2, 1, 2, 2, 2, 2, 2, 0, 0, 0, 0, 0, 1, 0, 1, 2, 2, 0, 0, 0, 0, 0, 2, 0, 2, 2, 1, 1, 1, 2, 2, 1, 1, 0, 1, 0, 0, 2, 0, 0, 0, 0, 15, 2, 0, 1, 0, 0, 0, 0, 0, 7, 1, 2, 2, 0, 1, 0, 0, 2, 2, 0, 4, 2, 2, 0, 0, 7, 0, 1, 2, 1, 0, 5, 6, 0, 5, 0, 4, 1, 4, 1, 1, 0, 3, 2, 1, 0, 1]
[0, 1, 1, 2, 13, 0, 3, 0, 0, 1, 2, 6, 1, 0, 0, 0, 1, 2, 1, 0, 0, 2, 7, 0, 0, 7, 0, 2, 2, 0, 2, 0, 1, 1, 3, 0, 2, 7, 1, 0, 1, 3, 2, 1, 1, 0, 1, 3, 0, 2, 9, 0, 1, 2, 2, 0, 1, 0, 2, 1, 0, 0, 6, 0, 2, 0, 0, 4, 2, 0, 1, 0, 0, 9, 2, 0, 0, 7, 2, 0, 7, 0, 4, 0, 0, 1, 9, 1, 8, 6, 1, 2, 8, 0, 1, 6, 5, 0, 2, 2, 2]
[0, 1, 1, 2, 0, 2, 2, 2, 1, 1, 2, 6, 1, 0, 0, 0, 1, 2, 1, 0, 0, 2, 2, 0, 2, 0, 0, 2, 2, 0, 7, 0, 0, 3, 3, 0, 2, 2, 1, 1, 1, 2, 2, 1, 1, 0, 1, 1, 0, 0, 2, 2, 1, 0, 2, 0, 2, 2, 2, 0, 0, 0, 1, 0, 2, 0, 1, 2, 2, 1, 1, 0, 0, 1, 2, 0, 0, 0, 2, 0, 2, 2, 2, 1, 0, 1, 2, 1, 2, 2, 0, 1, 2, 1, 4, 0, 0, 8, 1, 1, 1]
[0, 1, 1, 2, 0, 2, 2, 2, 1, 0, 1, 1, 2, 1, 2, 2, 2, 2, 2, 0, 0, 2, 2, 0, 2, 0, 0, 2, 2, 0, 7, 0, 0, 3, 3, 0, 2, 2, 1, 1, 1, 2, 2, 1, 1, 0, 1, 1, 0, 0, 2, 2, 1, 0, 2, 0, 2, 2, 2, 0, 0, 0, 1, 0, 2, 0, 1, 2, 2, 1, 1, 0, 0, 1, 2, 0, 0, 0, 2, 0, 2, 2, 2, 1, 0, 1, 2, 1, 2, 2, 0, 1, 2, 1, 4, 0, 0, 8, 1, 1, 1]
[0, 1, 1, 2, 0, 2, 2, 2, 1, 0, 1, 1, 2, 1, 2, 2, 2, 2, 2, 0, 0, 0, 0, 0, 1, 0, 1, 2, 2, 0, 0, 0, 0, 0, 2, 0, 2, 2, 1, 1, 1, 2, 2, 1, 1, 0, 1, 3, 0, 0, 9, 2, 1, 2, 1, 0, 1, 0, 2, 2, 1, 0, 1, 0, 2, 0, 1, 2, 2, 1, 1, 0, 1, 0, 0, 1, 2, 0, 1, 1, 0, 0, 2, 0, 0, 2, 1, 2, 2, 0, 0, 1, 2, 1, 4, 0, 0, 8, 1, 1, 1]
[0, 1, 1, 6, 2, 1, 0, 0, 0, 0, 2, 0, 6, 1, 0, 2, 6, 2, 1, 4, 0, 3, 1, 0, 2, 0, 0, 2, 2, 0, 7, 0, 1, 1, 1, 0, 2, 0, 0, 2, 2, 2, 0, 0, 2, 0, 0, 4, 0, 2, 0, 12, 1, 7, 0, 0, 4, 6, 5, 0, 2, 2, 1, 7, 2, 7, 0, 0, 0, 0, 3, 0, 11, 0, 0, 0, 9, 0, 2, 7, 2, 9, 2, 8, 0, 13, 0, 0, 2, 9, 0, 0, 2, 1, 0, 4, 2, 2, 3, 2, 0]
