[1, 2, 2, 1, 0, 0, 0, 1, 2, 1, 0, 0, 1, 0, 1, 0, 1, 1, 1, 1, 0, 0, 0, 2, 2, 1, 2, 0, 2, 0, 2, 1, 1, 1, 0, 1, 1, 1, 1, 0, 0, 0, 2, 2, 4, 3, 0, 13, 7, 7, 9, 0, 0, 0, 0, 11, 6, 1, 12, 2, 6, 4, 6, 6, 2, 2, 0, 0, 0, 3, 0, 2, 9, 7, 0, 5, 6, 2, 2, 2, 1, 11, 1, 0, 5, 0, 0, 5, 1, 2, 5, 2, 1, 0, 1, 1, 2, 5, 0, 1, 2]
[1, 2, 2, 1, 0, 0, 0, 1, 2, 1, 0, 0, 1, 0, 1, 0, 1, 1, 1, 1, 0, 0, 0, 2, 2, 1, 2, 0, 2, 0, 2, 1, 1, 1, 0, 1, 0, 0, 2, 2, 1, 2, 2, 2, 1, 2, 0, 2, 1, 2, 0, 1, 0, 2, 0, 2, 1, 1, 0, 2, 1, 1, 1, 1, 0, 2, 1, 2, 1, 0, 0, 2, 0, 1, 2, 0, 1, 2, 2, 2, 1, 1, 1, 2, 2, 2, 2, 2, 1, 1, 0, 1, 4, 2, 0, 1, 0, 4, 0, 1, 0]
[4, 3, 0, 4, 5, 0, 0, 2, 1, 1, 2, 1, 0, 4, 0, 1, 0, 0, 2, 6, 2, 6, 1, 0, 0, 2, 1, 2, 0, 0, 2, 1, 0, 1, 0, 1, 4, 7, 2, 2, 1, 2, 0, 2, 5, 0, 0, 2, 0, 9, 0, 0, 1, 1, 0, 2, 0, 0, 0, 4, 7, 2, 0, 5, 2, 4, 2, 2, 1, 0, 7, 0, 2, 0, 1, 0, 1, 2, 2, 2, 1, 0, 1, 2, 0, 0, 2, 2, 1, 1, 1, 0, 1, 0, 4, 5, 6, 1, 5, 2, 2]
[1, 2, 2, 1, 0, 0, 0, 1, 2, 1, 0, 0, 1, 0, 1, 0, 1, 1, 1, 1, 0, 0, 0, 2, 2, 1, 2, 0, 2, 0, 2, 1, 1, 1, 0, 1, 4, 7, 2, 2, 1, 2, 0, 2, 5, 0, 0, 2, 0, 9, 0, 0, 1, 1, 0, 2, 0, 0, 0, 4, 7, 2, 0, 5, 2, 4, 2, 2, 1, 0, 7, 0, 2, 0, 1, 0, 1, 2, 2, 2, 1, 0, 1, 2, 0, 0, 2, 2, 1, 1, 1, 0, 1, 0, 4, 5, 6, 1, 5, 2, 2]
[4, 3, 0, 4, 5, 0, 0, 2, 1, 1, 2, 1, 0, 4, 0, 1, 0, 0, 2, 6, 2, 6, 1, 0, 0, 2, 1, 2, 0, 0, 2, 1, 0, 1, 0, 1, 4, 7, 2, 2, 1, 2, 0, 2, 5, 0, 0, 2, 1, 2, 0, 1, 0, 2, 0, 2, 1, 1, 0, 2, 2, 2, 1, 1, 2, 0, 2, 2, 1, 0, 2, 1, 0, 1, 2, 0, 1, 2, 2, 2, 1, 1, 1, 2, 2, 2, 2, 2, 1, 1, 0, 1, 4, 2, 0, 1, 0, 4, 0, 1, 0]
[1, 2, 2, 1, 0, 0, 0, 1, 2, 1, 0, 0, 1, 0, 1, 0, 1, 1, 1, 1, 0, 0, 0, 2, 2, 1, 2, 0, 2, 0, 2, 1, 1, 1, 0, 1, 4, 7, 2, 2, 1, 2, 0, 2, 5, 0, 0, 2, 0, 9, 0, 0, 1, 1, 0, 2, 0, 0, 0, 4, 7, 2, 0, 5, 2, 4, 2, 2, 1, 0, 7, 0, 2, 0, 1, 0, 1, 2, 2, 2, 1, 0, 1, 2, 0, 0, 2, 2, 1, 1, 1, 0, 1, 0, 4, 5, 6, 1, 5, 2, 2]
[4, 3, 0, 4, 5, 0, 0, 2, 1, 1, 2, 1, 0, 4, 0, 1, 0, 0, 2, 6, 2, 6, 1, 0, 0, 2, 1, 2, 0, 0, 2, 1, 0, 1, 0, 1, 4, 7, 2, 2, 1, 2, 0, 2, 5, 0, 0, 2, 0, 9, 0, 0, 1, 1, 0, 2, 0, 0, 0, 4, 7, 2, 0, 5, 2, 4, 2, 2, 1, 0, 7, 0, 2, 0, 1, 0, 1, 2, 2, 2, 1, 0, 1, 2, 0, 0, 2, 2, 1, 1, 1, 0, 1, 0, 4, 5, 6, 1, 5, 2, 2]
[4, 3, 0, 4, 5, 0, 0, 2, 1, 1, 2, 1, 0, 4, 0, 1, 0, 0, 2, 6, 2, 6, 1, 0, 0, 2, 1, 2, 0, 0, 2, 1, 0, 1, 0, 1, 4, 7, 2, 2, 1, 2, 2, 2, 1, 2, 0, 2, 1, 2, 0, 1, 0, 2, 0, 2, 1, 1, 0, 2, 2, 2, 1, 1, 2, 0, 2, 2, 1, 0, 2, 1, 0, 0, 1, 0, 2, 1, 1, 1, 0, 1, 0, 1, 1, 1, 0, 7, 2, 4, 0, 1, 4, 2, 0, 1, 0, 4, 0, 1, 0]
[1, 2, 2, 1, 0, 0, 0, 1, 2, 1, 0, 0, 1, 0, 1, 0, 1, 1, 1, 1, 0, 0, 0, 2, 2, 1, 2, 0, 2, 0, 2, 1, 1, 1, 0, 1, 0, 0, 2, 2, 1, 2, 2, 2, 1, 2, 0, 12, 0, 0, 7, 0, 0, 0, 0, 11, 6, 1, 7, 2, 6, 1, 1, 1, 2, 2, 0, 2, 0, 0, 0, 2, 0, 1, 2, 0, 1, 2, 2, 2, 1, 1, 1, 2, 2, 2, 2, 2, 1, 1, 0, 2, 0, 0, 1, 1, 2, 2, 2, 1, 2]
[1, 2, 2, 1, 0, 0, 0, 1, 2, 1, 0, 0, 1, 0, 1, 0, 1, 1, 1, 1, 0, 0, 0, 2, 2, 1, 2, 0, 2, 0, 2, 1, 1, 1, 0, 1, 0, 0, 2, 2, 1, 2, 2, 2, 1, 2, 0, 12, 0, 0, 7, 0, 0, 0, 0, 11, 6, 1, 7, 2, 6, 1, 1, 1, 2, 2, 0, 2, 0, 3, 0, 2, 6, 7, 2, 5, 9, 2, 2, 2, 1, 11, 1, 0, 2, 2, 2, 5, 1, 1, 0, 7, 2, 0, 2, 0, 0, 5, 1, 1, 2]
[1, 3, 5, 8, 0, 0, 0, 7, 5, 0, 4, 0, 0, 3, 0, 2, 0, 1, 0, 1, 0, 0, 8, 2, 0, 0, 2, 6, 2, 0, 2, 1, 1, 1, 0, 1, 0, 0, 2, 2, 0, 2, 2, 2, 1, 2, 0, 2, 0, 2, 0, 0, 0, 2, 0, 9, 1, 1, 0, 2, 2, 2, 0, 1, 1, 0, 5, 1, 1, 0, 0, 1, 0, 7, 3, 3, 2, 5, 1, 0, 5, 1, 0, 1, 1, 0, 0, 0, 1, 2, 2, 0, 0, 1, 1, 1, 0, 2, 0, 0, 0]
[1, 2, 1, 1, 0, 0, 0, 1, 2, 7, 0, 0, 4, 0, 1, 0, 1, 1, 1, 1, 6, 0, 0, 0, 2, 0, 2, 0, 2, 2, 9, 1, 1, 1, 0, 1, 1, 0, 2, 2, 8, 2, 2, 4, 1, 3, 0, 7, 1, 5, 0, 1, 0, 2, 0, 11, 6, 1, 12, 6, 6, 4, 6, 11, 2, 5, 0, 0, 0, 3, 0, 2, 9, 8, 0, 5, 6, 2, 2, 0, 1, 11, 1, 0, 5, 0, 0, 9, 3, 0, 5, 2, 5, 0, 1, 5, 2, 5, 0, 1, 7]
[1, 2, 2, 1, 0, 0, 0, 1, 2, 1, 0, 0, 1, 0, 1, 0, 1, 1, 1, 1, 0, 0, 0, 2, 2, 1, 2, 0, 2, 0, 2, 1, 1, 1, 0, 1, 0, 0, 2, 2, 1, 2, 2, 2, 1, 2, 0, 2, 1, 2, 0, 0, 1, 1, 0, 2, 0, 0, 0, 4, 7, 2, 0, 5, 2, 4, 2, 2, 1, 0, 7, 0, 2, 0, 1, 0, 1, 2, 2, 2, 1, 0, 1, 2, 0, 0, 2, 2, 1, 1, 1, 0, 1, 0, 4, 5, 6, 1, 5, 2, 2]
[1, 2, 0, 8, 0, 0, 0, 7, 5, 1, 0, 0, 0, 0, 0, 2, 0, 1, 3, 1, 0, 0, 7, 2, 1, 0, 2, 6, 2, 1, 1, 0, 0, 2, 0, 0, 7, 2, 1, 0, 1, 0, 2, 2, 2, 3, 0, 2, 7, 9, 2, 2, 0, 0, 0, 0, 2, 0, 0, 0, 9, 0, 0, 1, 2, 0, 11, 0, 0, 0, 1, 0, 1, 2, 1, 0, 2, 4, 2, 6, 0, 0, 4, 0, 8, 0, 0, 6, 5, 4, 3, 1, 2, 2, 0, 1, 0, 0, 0, 1, 0]
[1, 8, 2, 0, 1, 2, 0, 2, 4, 2, 2, 1, 0, 2, 0, 1, 0, 0, 9, 1, 2, 2, 1, 5, 1, 2, 2, 8, 0, 6, 1, 3, 1, 1, 0, 0, 1, 1, 1, 0, 0, 0, 2, 2, 4, 3, 0, 13, 7, 7, 9, 0, 0, 0, 0, 11, 6, 1, 12, 2, 6, 4, 6, 6, 2, 2, 0, 0, 0, 3, 0, 2, 9, 7, 0, 5, 6, 2, 2, 2, 1, 11, 1, 0, 5, 0, 0, 5, 1, 2, 5, 2, 1, 0, 1, 1, 2, 5, 0, 1, 2]
[1, 2, 2, 1, 0, 0, 0, 1, 2, 1, 0, 0, 1, 0, 1, 0, 1, 1, 1, 1, 0, 0, 0, 2, 2, 1, 2, 0, 2, 0, 2, 1, 1, 1, 0, 1, 0, 0, 2, 2, 1, 2, 2, 2, 1, 2, 0, 2, 1, 2, 0, 1, 0, 2, 0, 2, 1, 1, 0, 2, 2, 2, 1, 1, 2, 0, 2, 2, 1, 0, 0, 2, 0, 1, 2, 0, 1, 2, 2, 2, 1, 1, 1, 2, 2, 2, 2, 2, 1, 1, 0, 1, 4, 2, 0, 1, 0, 4, 0, 1, 0]
[1, 6, 8, 6, 6, 6, 0, 2, 0, 5, 2, 0, 5, 0, 11, 0, 5, 0, 2, 0, 4, 0, 1, 0, 6, 2, 0, 2, 2, 6, 5, 0, 1, 2, 0, 0, 4, 7, 2, 2, 6, 0, 0, 7, 5, 0, 6, 3, 0, 9, 0, 0, 0, 1, 0, 2, 7, 0, 0, 0, 7, 2, 0, 4, 1, 4, 2, 6, 1, 0, 7, 0, 5, 0, 1, 2, 1, 2, 2, 2, 8, 0, 1, 2, 0, 0, 6, 2, 1, 1, 1, 0, 0, 2, 2, 0, 0, 0, 8, 0, 0]
[1, 6, 8, 6, 6, 6, 0, 2, 0, 5, 2, 0, 5, 0, 11, 0, 5, 0, 2, 0, 4, 0, 1, 0, 6, 2, 0, 2, 2, 6, 5, 0, 1, 2, 0, 0, 1, 2, 1, 0, 6, 2, 8, 2, 2, 1, 0, 0, 0, 0, 0, 4, 2, 0, 0, 2, 4, 1, 0, 2, 0, 1, 1, 1, 5, 2, 1, 3, 3, 0, 0, 2, 0, 1, 2, 0, 1, 0, 0, 0, 1, 1, 8, 2, 2, 2, 7, 2, 0, 1, 0, 2, 3, 0, 3, 5, 2, 2, 2, 1, 0]
[5, 2, 2, 8, 0, 0, 0, 0, 2, 3, 0, 0, 1, 0, 1, 5, 1, 1, 1, 1, 0, 0, 0, 9, 8, 1, 2, 7, 0, 3, 2, 1, 1, 0, 3, 1, 8, 7, 6, 2, 2, 2, 0, 2, 5, 0, 0, 2, 0, 8, 0, 0, 1, 1, 6, 2, 0, 6, 15, 2, 6, 4, 6, 6, 2, 5, 0, 0, 0, 3, 0, 2, 9, 7, 0, 5, 6, 3, 2, 2, 1, 11, 6, 0, 5, 3, 0, 8, 1, 2, 5, 0, 1, 0, 1, 0, 9, 6, 0, 1, 2]
[1, 2, 2, 1, 0, 0, 0, 1, 2, 1, 0, 0, 1, 0, 1, 0, 1, 1, 1, 1, 0, 0, 0, 2, 2, 1, 2, 0, 2, 0, 2, 1, 1, 1, 0, 1, 0, 0, 2, 2, 1, 2, 2, 2, 1, 2, 0, 12, 0, 0, 7, 0, 0, 0, 0, 11, 6, 1, 7, 2, 6, 1, 1, 1, 2, 2, 0, 2, 0, 0, 0, 0, 1, 2, 1, 0, 2, 4, 2, 6, 1, 1, 1, 2, 2, 2, 2, 2, 1, 1, 0, 1, 4, 2, 0, 1, 0, 4, 0, 1, 0]
[1, 2, 2, 1, 0, 0, 0, 1, 2, 1, 0, 0, 1, 0, 1, 0, 1, 1, 1, 1, 0, 0, 0, 2, 2, 1, 2, 0, 2, 0, 2, 1, 1, 1, 0, 1, 0, 0, 2, 2, 1, 2, 2, 2, 1, 2, 0, 2, 1, 2, 0, 1, 0, 2, 0, 2, 1, 1, 0, 2, 2, 2, 1, 1, 2, 0, 2, 2, 1, 0, 2, 1, 0, 1, 2, 0, 1, 2, 2, 2, 1, 1, 1, 2, 2, 2, 2, 2, 1, 1, 0, 1, 4, 2, 0, 1, 0, 4, 0, 1, 0]
[1, 6, 8, 6, 6, 6, 0, 2, 0, 5, 2, 0, 5, 0, 11, 0, 5, 0, 2, 0, 4, 0, 1, 0, 0, 2, 1, 2, 0, 0, 2, 1, 1, 2, 0, 0, 1, 2, 1, 0, 1, 2, 2, 2, 2, 1, 0, 0, 0, 0, 0, 0, 2, 0, 0, 2, 1, 1, 0, 2, 1, 1, 1, 1, 0, 2, 1, 2, 1, 0, 0, 2, 0, 1, 2, 0, 1, 2, 2, 2, 1, 1, 1, 2, 2, 2, 2, 2, 1, 1, 1, 0, 1, 0, 0, 1, 0, 1, 1, 2, 2]
[1, 3, 5, 8, 0, 0, 0, 7, 5, 0, 4, 0, 0, 3, 0, 2, 0, 1, 0, 1, 0, 0, 8, 2, 0, 0, 2, 6, 2, 0, 2, 1, 1, 1, 0, 1, 0, 0, 2, 2, 0, 2, 2, 2, 1, 2, 0, 2, 1, 2, 0, 1, 0, 2, 0, 2, 1, 1, 0, 2, 2, 2, 1, 1, 2, 0, 2, 2, 1, 0, 2, 1, 0, 0, 1, 0, 2, 1, 1, 1, 0, 1, 0, 1, 1, 1, 0, 0, 1, 2, 2, 0, 0, 1, 1, 1, 0, 2, 0, 0, 0]
[1, 0, 0, 1, 0, 0, 0, 1, 4, 1, 0, 0, 1, 0, 0, 0, 1, 4, 1, 1, 0, 0, 0, 2, 2, 1, 2, 0, 0, 5, 2, 4, 1, 1, 0, 1, 0, 0, 2, 0, 1, 2, 0, 2, 1, 2, 0, 2, 0, 9, 0, 1, 8, 1, 0, 2, 0, 0, 0, 4, 7, 2, 0, 5, 5, 11, 5, 1, 1, 0, 0, 1, 0, 7, 3, 3, 2, 5, 7, 6, 5, 0, 0, 1, 1, 2, 0, 0, 1, 2, 2, 0, 0, 1, 1, 1, 0, 1, 0, 5, 0]
[1, 2, 2, 1, 0, 0, 0, 1, 2, 1, 0, 0, 1, 0, 1, 0, 1, 1, 1, 1, 0, 0, 0, 2, 2, 1, 2, 0, 2, 0, 2, 1, 1, 1, 0, 1, 0, 0, 2, 2, 1, 2, 2, 2, 1, 2, 0, 2, 0, 9, 0, 0, 1, 1, 0, 2, 0, 0, 0, 4, 7, 2, 0, 5, 2, 4, 2, 2, 1, 0, 7, 0, 2, 0, 1, 0, 1, 2, 2, 2, 1, 0, 1, 2, 0, 0, 2, 2, 1, 1, 1, 0, 1, 0, 4, 5, 6, 1, 5, 2, 2]
[1, 2, 0, 8, 0, 0, 0, 7, 5, 1, 0, 0, 5, 0, 11, 0, 5, 0, 2, 0, 4, 0, 1, 0, 6, 2, 0, 2, 2, 6, 5, 0, 1, 2, 0, 0, 1, 2, 1, 0, 6, 2, 8, 2, 2, 1, 0, 0, 0, 0, 0, 4, 2, 0, 0, 2, 4, 1, 0, 2, 0, 1, 1, 1, 5, 2, 1, 3, 3, 0, 0, 2, 0, 1, 2, 0, 1, 0, 0, 0, 1, 1, 8, 2, 2, 2, 7, 2, 0, 1, 0, 2, 3, 0, 3, 5, 2, 2, 2, 1, 0]
[1, 2, 2, 1, 0, 0, 0, 1, 2, 1, 0, 0, 1, 0, 1, 0, 1, 1, 1, 1, 0, 0, 0, 2, 2, 1, 2, 0, 2, 0, 2, 1, 1, 1, 0, 1, 0, 0, 2, 2, 1, 2, 2, 2, 1, 2, 0, 2, 1, 2, 0, 1, 0, 2, 0, 2, 1, 1, 0, 2, 2, 2, 1, 1, 2, 0, 2, 2, 1, 0, 0, 2, 0, 1, 2, 0, 1, 2, 2, 2, 1, 1, 1, 2, 2, 2, 2, 2, 1, 1, 0, 1, 4, 2, 0, 1, 0, 4, 0, 1, 0]
[1, 2, 1, 5, 1, 0, 5, 1, 2, 7, 0, 0, 4, 0, 1, 0, 1, 1, 0, 6, 11, 0, 5, 0, 2, 0, 2, 0, 5, 2, 16, 0, 1, 1, 0, 1, 1, 0, 0, 2, 7, 5, 2, 0, 1, 0, 12, 3, 5, 7, 0, 0, 0, 1, 0, 2, 7, 1, 0, 0, 7, 2, 0, 4, 1, 9, 2, 5, 1, 0, 7, 0, 5, 0, 1, 2, 1, 2, 2, 2, 8, 0, 0, 2, 0, 0, 6, 5, 1, 1, 1, 0, 0, 0, 2, 0, 0, 0, 14, 0, 4]
[4, 3, 0, 4, 5, 0, 0, 2, 1, 1, 2, 1, 0, 4, 0, 1, 0, 0, 2, 6, 2, 6, 1, 0, 0, 2, 1, 2, 0, 0, 2, 1, 0, 1, 0, 1, 4, 7, 2, 2, 1, 2, 0, 2, 5, 0, 0, 2, 1, 2, 0, 1, 0, 2, 0, 2, 1, 1, 0, 2, 2, 2, 1, 1, 2, 0, 2, 2, 1, 0, 2, 1, 0, 1, 2, 0, 1, 2, 2, 2, 1, 1, 1, 2, 2, 2, 2, 2, 1, 1, 0, 2, 0, 0, 1, 1, 2, 2, 2, 1, 2]
[1, 3, 5, 8, 0, 0, 0, 7, 5, 0, 4, 0, 0, 3, 0, 2, 0, 1, 0, 1, 0, 0, 8, 2, 0, 0, 2, 6, 2, 0, 2, 1, 1, 1, 0, 1, 0, 0, 2, 2, 0, 2, 2, 2, 1, 2, 0, 2, 1, 2, 0, 1, 0, 2, 0, 2, 1, 1, 0, 2, 2, 2, 1, 1, 2, 0, 2, 2, 1, 3, 0, 2, 9, 8, 0, 5, 6, 2, 2, 0, 1, 11, 1, 0, 5, 0, 0, 9, 3, 0, 5, 2, 5, 0, 1, 5, 2, 5, 0, 1, 7]
[1, 6, 8, 6, 6, 6, 0, 2, 0, 5, 2, 0, 5, 0, 11, 0, 5, 0, 2, 0, 4, 0, 1, 0, 0, 2, 1, 2, 0, 0, 2, 1, 1, 2, 0, 0, 1, 2, 1, 0, 1, 2, 2, 2, 2, 1, 0, 0, 0, 0, 0, 0, 2, 0, 0, 2, 1, 1, 0, 2, 1, 1, 1, 1, 0, 2, 1, 2, 1, 0, 0, 2, 0, 1, 2, 0, 1, 2, 2, 2, 1, 1, 1, 2, 2, 2, 2, 2, 1, 1, 1, 0, 1, 0, 0, 1, 0, 1, 1, 2, 2]
[6, 2, 6, 0, 0, 7, 0, 8, 1, 1, 0, 0, 0, 4, 1, 0, 0, 4, 1, 4, 0, 0, 4, 2, 0, 0, 2, 6, 2, 0, 2, 1, 2, 1, 0, 8, 0, 0, 2, 2, 2, 9, 2, 0, 1, 0, 0, 2, 1, 8, 0, 1, 0, 1, 0, 2, 1, 1, 0, 2, 2, 2, 1, 0, 9, 0, 2, 2, 0, 0, 2, 1, 0, 0, 1, 0, 1, 5, 1, 1, 0, 1, 7, 1, 1, 0, 0, 0, 1, 2, 0, 2, 0, 1, 0, 1, 3, 2, 0, 0, 0]
[4, 9, 5, 8, 0, 0, 5, 7, 0, 0, 4, 0, 0, 8, 0, 2, 5, 0, 0, 1, 0, 7, 8, 2, 0, 0, 0, 6, 2, 0, 2, 7, 1, 0, 0, 1, 0, 0, 1, 2, 0, 3, 2, 2, 1, 0, 0, 2, 0, 2, 0, 0, 0, 2, 0, 9, 1, 1, 0, 4, 2, 2, 0, 1, 1, 5, 0, 0, 0, 7, 0, 0, 9, 2, 0, 5, 6, 2, 8, 0, 1, 18, 1, 0, 5, 3, 3, 8, 9, 6, 9, 2, 5, 0, 0, 5, 2, 5, 3, 4, 7]
[1, 2, 2, 1, 0, 0, 0, 1, 2, 1, 0, 0, 1, 0, 1, 0, 1, 1, 1, 1, 0, 0, 0, 2, 2, 1, 2, 0, 2, 0, 2, 1, 1, 1, 0, 1, 0, 0, 2, 2, 1, 2, 2, 2, 1, 2, 0, 0, 0, 0, 0, 0, 2, 0, 0, 2, 1, 1, 0, 2, 1, 1, 1, 1, 0, 2, 1, 2, 1, 0, 0, 2, 0, 1, 2, 0, 1, 2, 2, 2, 1, 1, 1, 2, 2, 2, 2, 2, 1, 1, 1, 0, 1, 0, 0, 1, 0, 1, 1, 2, 2]
[1, 3, 5, 8, 0, 0, 0, 7, 5, 0, 4, 0, 0, 3, 0, 2, 0, 1, 0, 1, 0, 0, 8, 2, 0, 0, 2, 6, 2, 0, 2, 1, 1, 1, 0, 1, 0, 0, 2, 2, 0, 2, 2, 2, 1, 2, 0, 2, 1, 2, 0, 1, 0, 2, 0, 2, 1, 1, 0, 2, 2, 2, 1, 1, 2, 0, 2, 2, 1, 0, 2, 1, 0, 0, 1, 0, 2, 1, 1, 1, 0, 1, 0, 1, 1, 1, 0, 2, 1, 1, 1, 0, 1, 0, 4, 5, 6, 1, 5, 2, 2]
[1, 2, 1, 1, 0, 0, 0, 1, 2, 7, 0, 0, 4, 0, 1, 0, 1, 1, 1, 1, 6, 0, 0, 0, 2, 0, 2, 0, 2, 2, 9, 1, 1, 1, 0, 1, 1, 0, 2, 2, 8, 2, 2, 4, 1, 3, 0, 7, 1, 5, 0, 1, 0, 2, 0, 11, 6, 1, 12, 6, 6, 4, 6, 11, 2, 5, 0, 0, 0, 0, 0, 1, 0, 7, 3, 3, 2, 5, 7, 6, 5, 0, 0, 1, 1, 2, 0, 0, 1, 2, 2, 0, 0, 1, 1, 1, 0, 1, 0, 5, 0]
[1, 6, 8, 6, 6, 6, 0, 2, 0, 5, 2, 0, 5, 0, 11, 0, 5, 0, 2, 0, 4, 0, 1, 0, 6, 2, 0, 2, 2, 6, 5, 0, 1, 2, 0, 0, 4, 7, 2, 2, 6, 0, 0, 7, 5, 0, 6, 3, 0, 9, 0, 0, 0, 2, 0, 2, 1, 1, 0, 2, 2, 2, 1, 1, 2, 0, 2, 2, 1, 0, 2, 1, 0, 0, 1, 0, 2, 1, 1, 1, 0, 1, 0, 1, 1, 1, 0, 7, 2, 4, 0, 1, 4, 2, 0, 1, 0, 4, 0, 1, 0]
[1, 2, 1, 1, 0, 0, 0, 1, 2, 7, 0, 0, 4, 0, 1, 0, 1, 1, 1, 1, 6, 0, 0, 0, 2, 0, 2, 0, 2, 2, 9, 1, 1, 1, 0, 1, 1, 0, 2, 2, 8, 2, 2, 4, 1, 3, 0, 7, 1, 5, 0, 1, 0, 2, 0, 11, 6, 1, 12, 2, 6, 4, 6, 6, 2, 2, 0, 0, 0, 3, 0, 2, 9, 7, 0, 5, 6, 2, 2, 2, 1, 11, 1, 0, 5, 0, 0, 5, 1, 2, 5, 2, 1, 0, 1, 1, 2, 5, 0, 1, 2]
[4, 3, 8, 6, 6, 6, 0, 2, 0, 5, 2, 0, 5, 0, 11, 0, 5, 0, 2, 0, 4, 0, 1, 0, 6, 2, 0, 2, 2, 6, 5, 0, 1, 2, 0, 0, 4, 7, 2, 2, 6, 0, 0, 7, 5, 0, 6, 3, 0, 9, 0, 0, 0, 1, 0, 2, 7, 0, 0, 0, 7, 2, 0, 4, 1, 4, 2, 6, 1, 0, 7, 0, 5, 0, 1, 2, 1, 2, 2, 2, 8, 0, 1, 2, 0, 0, 6, 2, 1, 1, 1, 0, 0, 2, 2, 0, 0, 0, 8, 0, 0]
[1, 2, 2, 1, 0, 0, 0, 1, 2, 1, 0, 0, 1, 0, 1, 0, 1, 1, 1, 1, 0, 0, 0, 2, 2, 1, 2, 0, 2, 0, 2, 1, 1, 1, 0, 1, 0, 0, 2, 2, 1, 2, 2, 2, 1, 2, 0, 12, 0, 0, 0, 4, 2, 0, 0, 2, 4, 1, 0, 2, 0, 1, 1, 1, 5, 2, 1, 3, 3, 0, 0, 2, 0, 1, 2, 0, 1, 0, 0, 0, 1, 1, 8, 2, 2, 2, 7, 2, 0, 1, 0, 2, 3, 0, 3, 5, 2, 2, 2, 1, 0]
[1, 2, 2, 1, 0, 0, 0, 1, 2, 1, 0, 0, 1, 0, 1, 0, 1, 1, 1, 1, 0, 0, 0, 2, 2, 1, 2, 0, 2, 0, 2, 1, 1, 1, 0, 1, 0, 0, 2, 2, 1, 2, 2, 2, 1, 2, 0, 2, 1, 2, 0, 0, 1, 1, 0, 2, 0, 0, 0, 4, 7, 2, 0, 5, 2, 4, 2, 2, 1, 0, 7, 0, 2, 0, 1, 0, 1, 2, 2, 2, 1, 0, 1, 2, 0, 0, 2, 2, 1, 1, 1, 0, 1, 0, 4, 5, 6, 1, 5, 2, 2]
[4, 6, 8, 6, 6, 6, 0, 2, 0, 5, 5, 0, 5, 0, 11, 0, 7, 0, 2, 6, 2, 0, 3, 7, 3, 2, 0, 0, 6, 0, 4, 3, 0, 0, 0, 0, 1, 2, 1, 0, 8, 2, 8, 2, 2, 1, 0, 0, 0, 0, 2, 4, 2, 0, 0, 0, 4, 0, 0, 3, 0, 1, 3, 1, 2, 0, 3, 2, 5, 0, 2, 1, 0, 1, 2, 0, 2, 2, 2, 7, 1, 5, 1, 4, 2, 2, 0, 6, 7, 3, 0, 7, 4, 4, 3, 1, 0, 8, 0, 1, 0]
[1, 3, 8, 6, 8, 4, 0, 1, 1, 6, 9, 0, 6, 0, 11, 0, 5, 0, 0, 0, 10, 0, 1, 0, 0, 2, 1, 9, 0, 1, 2, 1, 0, 5, 0, 0, 1, 8, 5, 4, 1, 4, 2, 8, 2, 1, 0, 0, 0, 0, 0, 0, 2, 0, 0, 2, 4, 1, 4, 2, 1, 1, 0, 0, 0, 6, 11, 1, 2, 6, 0, 1, 2, 12, 3, 3, 2, 5, 1, 0, 9, 1, 0, 1, 7, 0, 0, 0, 0, 2, 0, 0, 0, 1, 4, 0, 0, 2, 0, 0, 0]
[1, 2, 2, 1, 0, 0, 0, 1, 2, 1, 0, 0, 1, 0, 1, 0, 1, 1, 1, 1, 0, 0, 0, 2, 2, 1, 2, 0, 2, 0, 2, 1, 1, 1, 0, 1, 4, 7, 2, 2, 1, 2, 0, 2, 5, 0, 0, 2, 0, 9, 9, 0, 0, 0, 0, 11, 6, 1, 12, 2, 6, 4, 6, 6, 2, 2, 0, 0, 0, 3, 0, 2, 9, 7, 0, 5, 6, 2, 2, 2, 1, 11, 1, 0, 5, 0, 0, 5, 1, 2, 5, 2, 1, 0, 1, 1, 2, 5, 0, 1, 2]
[1, 2, 2, 1, 0, 0, 0, 1, 2, 1, 0, 0, 1, 0, 1, 0, 1, 1, 1, 1, 0, 0, 0, 2, 2, 1, 2, 0, 2, 0, 2, 1, 1, 1, 0, 1, 4, 7, 2, 2, 1, 2, 0, 2, 5, 0, 0, 2, 7, 9, 2, 2, 0, 0, 0, 0, 2, 0, 0, 0, 9, 0, 0, 1, 2, 0, 11, 0, 0, 0, 1, 0, 1, 2, 1, 0, 2, 4, 2, 6, 0, 0, 4, 0, 8, 0, 0, 6, 5, 4, 3, 1, 2, 2, 0, 1, 0, 0, 0, 1, 0]
[4, 3, 0, 4, 5, 0, 0, 2, 1, 1, 2, 1, 0, 4, 0, 1, 0, 0, 2, 6, 2, 6, 1, 0, 6, 2, 0, 2, 2, 6, 5, 0, 1, 2, 0, 0, 4, 7, 2, 2, 6, 0, 0, 7, 5, 0, 6, 3, 0, 9, 0, 0, 0, 1, 0, 2, 7, 0, 0, 0, 7, 2, 0, 4, 1, 4, 2, 6, 1, 0, 7, 0, 5, 0, 1, 2, 1, 2, 2, 2, 8, 0, 1, 2, 0, 0, 6, 2, 1, 1, 1, 0, 0, 2, 2, 0, 0, 0, 8, 0, 0]
[1, 2, 2, 1, 0, 0, 0, 1, 2, 1, 2, 1, 0, 4, 0, 1, 0, 0, 2, 6, 2, 6, 1, 0, 0, 2, 1, 2, 0, 0, 2, 1, 0, 1, 0, 1, 4, 7, 2, 2, 1, 2, 0, 2, 5, 0, 0, 2, 1, 2, 0, 1, 0, 2, 0, 2, 1, 1, 0, 2, 2, 2, 1, 1, 2, 0, 2, 2, 1, 0, 2, 1, 0, 1, 2, 0, 1, 2, 2, 2, 1, 1, 1, 2, 2, 2, 2, 2, 1, 1, 0, 1, 4, 2, 0, 1, 0, 4, 0, 1, 0]
[1, 2, 2, 1, 0, 0, 0, 1, 2, 1, 0, 0, 1, 0, 1, 0, 1, 1, 1, 1, 2, 6, 1, 0, 0, 2, 1, 2, 0, 0, 2, 1, 0, 1, 0, 1, 4, 7, 2, 2, 1, 2, 0, 2, 5, 0, 0, 2, 1, 2, 0, 1, 0, 2, 0, 2, 1, 1, 0, 2, 2, 2, 1, 1, 2, 0, 2, 2, 1, 0, 2, 1, 0, 1, 2, 0, 1, 2, 2, 2, 1, 1, 1, 2, 2, 2, 2, 2, 1, 1, 0, 1, 4, 2, 0, 1, 0, 4, 0, 1, 0]
[1, 2, 2, 1, 0, 0, 0, 1, 2, 1, 0, 0, 1, 0, 1, 0, 1, 1, 1, 1, 0, 0, 0, 2, 2, 1, 2, 0, 2, 0, 2, 1, 1, 1, 0, 1, 4, 7, 2, 2, 1, 2, 0, 2, 5, 0, 0, 2, 0, 9, 0, 0, 1, 1, 0, 2, 0, 0, 0, 4, 7, 2, 1, 1, 2, 0, 2, 2, 1, 0, 2, 1, 0, 0, 1, 0, 2, 1, 1, 1, 0, 1, 0, 1, 1, 1, 0, 7, 2, 4, 0, 1, 4, 2, 0, 1, 0, 4, 0, 1, 0]
[1, 6, 8, 6, 6, 6, 0, 2, 0, 5, 2, 0, 5, 0, 11, 0, 5, 0, 2, 0, 4, 0, 1, 0, 0, 2, 1, 2, 0, 0, 2, 1, 1, 2, 0, 0, 1, 2, 1, 0, 1, 2, 2, 2, 2, 3, 0, 13, 7, 7, 9, 0, 0, 0, 0, 11, 6, 1, 12, 2, 6, 4, 6, 6, 2, 2, 0, 0, 0, 3, 0, 2, 9, 7, 0, 5, 6, 2, 2, 2, 1, 11, 1, 0, 5, 0, 0, 5, 1, 2, 5, 2, 1, 0, 1, 1, 2, 5, 0, 1, 2]
